0 0 0 0 0 0 0 0 0 0 0 0 0 0 0 0 0 0
0 1 0 0 1 0 0 0 1 1 0 0 0 1 0 0 1 0
0 1 0 0 1 0 0 0 1 1 0 0 0 1 0 0 1 0
0 1 1 0 1 0 4 0 1 1 0 4 0 1 0 1 1 0
0 1 0 0 1 0 0 0 1 1 0 0 0 1 0 0 1 0
0 1 0 0 1 0 0 0 1 1 0 0 0 1 0 0 1 0
0 1 0 0 1 0 0 0 1 1 0 0 0 1 0 0 1 0
0 1 0 1 1 0 0 0 1 1 0 0 0 1 1 0 1 0
0 1 0 0 1 0 0 0 1 1 0 0 0 1 0 0 1 0
0 2 2 2 2 2 4 0 2 2 0 4 2 2 2 2 2 0
0 0 0 0 0 0 0 0 0 0 0 0 0 0 0 0 0 0
0 0 0 0 0 0 0 0 0 0 0 0 0 0 0 0 0 0